NO ./textures/texture1.png
SO ./textures/texture2.png
WE ./textures/texture3.png
EA ./textures/texture4.png

F 245,209,129
C 143,200,255

		1111111111111111111111111
		1000000000110000000000001
		1011000001110000000000001
		1001000000000000000000001
111111111011000001110000000000001
100000000011000001110111111111111
111101111111110111000000100011
111101111111110111010100100011
11000000110101011100000010001
10000000000000000000000010001
10000000000000001101010000001
11000S111010101111101111000111
11110111 1110101 101111010001
11111111 1111111 111111111111