NO ./textures/texture1.png
SO ./textures/texture2.png
WE ./textures/texture3.png
EA ./textures/texture4.png

F 245,209,129
C 143,200,255

		1111111111111111111111111111111111111111111111111111111111111111111111111111111111111111
		1000000000000000000000000000000000000000000000000110000000000000000000000000000000000001
		1010000000000000000000000000000000000000001000001110000000000000000000000000000000000001
		1000000000000000000000000000000000000000001000000000000000000000000000000000000000000001
111111111010000000000000000000000000000000000000001000001110000000000000000000000000000000000001
10000000001000000001111110000000000000000000000001000001110111111100000000000000000000000011111
11110111111000000001000110000000000000000000000001110111000000100000000000000000000000000011
11110111111000000001000110000000000000000000000001110111010100100000000000000000000000000011
1100000011000000000101111000000000000000000000000101011100000010000000000000000000000000001
10000000000000000000000000000000000000000000000000000000000000010000000000000000000000000001
10000000000000000000000000000000000000000000000000000001101010000000000000000000000000000001
11000S111010000000000000000000000000000000000000000101111101111000100000000000000000000000011
11110111 111010111011110100000000000000000000000000011111111111111111111111111111111111111111
11111111 1111111 11111111111111111111111111111111111