NO ./textures/texture2.png
SO ./textures/texture4.png
WE ./textures/texture3.png
EA ./textures/texture1.png

F 194, 147, 96
C 116, 221, 232

		1111111111111111111111111
		1000000000110000000000001					
		1011000001110000000000001					
		1001000000000000000000001					
111111111011000001110000000000001					
100000000011000001110111111111111					
11110111111111111111001111111111
111101111		1111001		
11110111111111111111101111111
11110111111111011100000010001						
11110111111111011101010010001						
11000000110101011100000010001						
10000000000000000000000010001						
10000000000000000001010000001						
11000001110101011111011110N0111						
11110111 1110101 101111010001						
11111111 1111111 111111111111						
