NO ./path_to_the_north_texture
SO ./path_to_the_south_texture
WE ./path_to_the_west_texture
EA ./path_to_the_east_texture

F 230,100, 21
C 122, 125, 9

		1111111111111111111111111
		1000000000110000000000001
		1011000001110000000000001
		1001000000000000000000001
111111111011000001110000000000001
100000000011000001110111122211111
11110111111111011100000010003
11110111111111011101010010003
11000000110101011100000010003
10000000000000001100000010003
10000000000000001101010000004
11000001110101011111011130N0211
11110111 1110101 101111040002
11111111 1111111 111111121234